abako	주판(珠板)
abelo	꿀벌
Adamo	아담
advokato	변호사
aero	공기
afiŝo	포스터
agento	대리인,	에이전트
aglo	독수리
agonio	단말마,	임종의고통
aidoso	에이즈
ajlo	마늘
akcelilo	악셀,	가스페달
aklamo,	ĝojkrio	환호
akordiono	아코디언
akrido	메뚜기
acrobat-trupo	곡마단akrobato	곡예사	
aktoro	배우
akupunkturo	침(술)
akuŝejo	조산원
akvario	수족관
akvo	물
akvofalo	폭포
akvomelono	수박
akvomuelilo	물레방아
akvoralo	뜸부기
alaŭdo	종달새
albumo	앨범
alfabeto	자모,	알파벳
alkoholaĵo	술
almozulo	거지
alta	tajdo	밀물
altruisto	박애주의자	
alumeto	성냥
amato	애인(남)
Amazono	아마존
ambasadoro	대사(大使)
amboso	모루
ambulanco	앰뷸런스
amiko	친구
amuleto	부적
analekto	어록(語錄)
analfabeto	문맹(文盲)
anaso	오리
anĝelo	천사(天使)
angilo	장어(뱀-)
angulo	모서리,	구석
ankro	닻
anonctabulo	게시판
ansero	거위
antarkto	남극
anteno	안테나,	촉각
anuso	항문(肛門)
apartamento	아파트
aperitivo	식욕돋우는음료,반주
apogmuro	축대(築臺)
apoteko	약국(藥局)
araneaĵo	거미줄
araneo	거미	
arbo	나무
arbusto	관목,	수풀,	덤불
arĝento	은(銀)
arkeo	(노아의)	방주
armistica	linio	휴전선
artsatelito	인공위성
artsketado	피겨스케이팅
astronomo	천문학자
ateisto	무신론자
atestilo,	atestaĵo	증명서	
atlantiko	대서양
atlaso	지도책
atmosfero	대기(大氣)
atom-energia	centalo	원자력	발전소
aŭditorio	강당,	대강의실
aŭkcio	경매(競賣)
aŭskultilo	이어폰
aŭto(mobilo)	자동차
aŭtodidakto	독학자
aŭtografio	자서전
aŭtoro	지은이
aŭtuno	가을
aviadilo	비행기
avizo	벽보,	포스터,	안내문
azaleo	진달래
azeno	당나귀
Babelturo	바벨탑
bakterio	균,	박테리아
balaaĵujo	쓰레기통
balailo	빗자루
baleno	고래
baleto,	baledo	발레	
balono	풍선,	애드벌룬
balotilo	투표용지
bambuo	대나무
banano	바나나
bandaĝo	붕대
bandito	노상강도,	산적
banejo	욕실
bankedo	연회
bankizo	빙산(氷山)
banklibro	은행	통장
banko	은행
bankuvo	욕조
bantuko	욕실	타울
barako	임시막사
barbirejo	이발소
barbiro	이발사
barbo	수염
barikado	바리케이트
barilo,	ĉirkaŭ~	울타리
basbalo	야구
baskulo	도개장치
baskulponto	도개교
bastono	막대기
batato	고구마
baterio	배터리
bazarkorbo	시장바구니
bazaro	시장(市場)
bebeno	실패,	보빈,	실타래
bebo	아기,	베이비
benko	벤치
benzino	휘발유
benzinstacio	주유소	
benzinstacio	주유소	
betono	콘크리트
Betoveno	베토벤
bibliofilo	애서가,	장서가
biblioteko	도서관
biciklo	자전거
biero	맥주
bilardo	당구
bildkadro	그림액자	
bildkarto	그림엽서
bildrakonto	만화(漫畵)
bileto	표,	입장권
binoklo	쌍안경
birdo	새
Bjalistoko	비얄리스토크
blindulo	맹인(盲人)
boaco	순록(馴鹿)
bofilo	사위
boksisto	권투선수
bombo	폭탄
bopatro	장인,	시아버지
borso	증권시장,증권거래소
botelo	병(甁)
boto	장화(長靴),	부츠
bovlo	그릇
bovo	소
braceleto	팔찌
brajlo	점자(點字)
brakhorloĝo	손목시계
brako	팔
brakumo	포옹
branĉo	가지(나무의-)
bremso	브레이크
breto	선반
brido	고삐,	굴레,	재갈
briko	벽돌
brizo	산들바람,	미풍
broĉo	브로치
brodaĵo	자수품	
broso	솔
broŝuro	팸플릿,	소책자
brovo	눈썹
brulligno	장작
bubalo	물소
budo	매점,	노점
bufo	두꺼비
bufro	범퍼,	완충기
buĝeto	예산
bukedo	꽃다발
buko	버클,	혁대쇠
buldozo	불도저
bumerango	부메랑
burĝono,	ŝoso	새싹
burso,	monujo	전대(纏帶)
buŝharmoniko	하모니카
buso	버스
buŝo	입[口]
busto	상반신,	반신상
buŝtuko	내프킨
butero	버터
butiko	가게
butono	단추
celo	목표,	목적지
celtabulo	과녁
cemento	시멘트
centaŭro	켄타우로스(반인반마)
centralo	발전소
cepo	양파
cerba	hemoragio	뇌출혈
cerbo	두뇌
cerealo	시리얼
cervo	사슴
cigaredo	담배
cikado	매미
cindro	재[灰]
cindrujo	재떨이
cirko	원형	곡마장
cirkulero	회람,	회보
ciro	구두
cunamo	쓰나미
dancisto	무용
delegito	대표,	델레기토
delfeno	돌핀
deliraĵo	잠꼬대
demenco	치매(癡呆)
demenculo	치매환자
demokratismo	민주주의
demono	귀신
dento	치아(齒牙)
dentobroso	치솔
dentopasto	치약
dentopikilo	이쑤시개
deserto	후식(後食)
detektivo	탐정,	형사
dezerto	사막(砂漠)
diamanto	다이아몬드
digo	댐
diktatoro	독재자
dimanĉo	일요일
dinastio	왕조(王朝)
dinosaŭro	공룡
dio	신(神)
diplomato	외교관
disĉiplo	제자,	문하생,	사도
disertacio	논문
dogano	세관
domo	집
donaco	선물	
dorm(ig)ilo	수면제
dormanto	잠자는	사람	
dormiranto	몽유병환자
dorno	가시
dorso	등[背]
drako	용(龍)
drinkejo	술집
duno	사구(砂丘)
duonpatrino	계모
duŝo	샤워
eburo	상아
eĥo,	resono	메아리
ekpluvo	소나기
ekrano	스크린,	화면
eksedziĝo	이혼(남자)
ekskurso	소풍
eksportisto	수출업자
ekspozicio	전시회,	박람회	
ekvatoro	적도(赤道)
ekzameno	시험(試驗)
elefanto	코끼리
elektro	전기(電氣)
elevatoro	엘리베이터elfosilo	포크레인,	굴착기
emerito	퇴직자
enciklopedio	백과사전
endoskopo	내시경
enscenigisto	피디(PD)
epicentro	진앙지(震央地)
erinaco	고슴도치
ermito	은둔자(隱遁者)
eskadro	(floto)	함대(艦隊)
eskimo	에스키모
esperantisto	에스페란토티스토
Esperanto	에스페란토
esperantolgo	에스페란토학
estrado	교단(敎壇)
Everesto	에베레스트
fabriko	공장(工場)
fadeno	실
fajfilo	호각,	기적(汽笛)
fajrilo	라이터
fajrobrigadano	소방대원
fajrobrigado	소방대(消防隊)
fakturo	청구서
faladpupo	오뚝이
falĉilo	낫
falsa	dento	틀니	
familio	가족
farbo(~isto)	페인트(~공)
fasto	단식(斷食)
fazano	꿩
fenestro	창문
ferio(tago)	휴일
festo	축제
fianĉamik(in)o	들러리	
figarbo	(figujo)	무화과나무
figursketado	피겨스케이팅
filmo	필름,	영화(필름)	
fingro	손가락
fiŝboato	어선(漁船)
fiŝhoko	낚시	바늘
fiŝisto	어부(漁夫)
fiŝo	물고기	
flago	깃발
flanko	옆구리
flava	sablero	황사(黃砂)
flegistino	간호사
floro	꽃
florpoto	화분(花盆)
florvazo	꽃병
floso	뗏목
flugbileto	비행기표
flughaveno	공항
flugilo	날개
fojno	건초(乾草)
folio	잎
folklora	vilaĝo	민속촌
fonografo	축음기,	유성기
fontano	분수(噴水)
fonto	샘,	샘물,	샘터
forcejo	온실,	비닐하우스
forĝisto	철공,대장장이
formiko	개미
forno	난로
forsitio	개나리
fortreso	요새(要塞)
fosilio	화석(化石)
fotelo	팔거리	의자
fotilo	사진기	
foto	사진
frago	딸기
frako	연미복(燕尾服)
frenezulo	미친사람,	광인
fridujo	냉장고
frizistino	미용사
frizosalono	미용실
fromaĵo	치즈
frukto	과일
fulmo	번개
fulmoforigilo	피뢰침
funebrulo	조객,문상객
fungo	버섯
galaksio	은하수
galerio	화랑(畵廊)
ganto	장갑
garantiulo	인질,	볼모	
gardrelo	가드레일	
gargaraĵo	가그린,	양치질약
gazeto	잡지
gazono	잔디
genealogio	족보,	가계(家系)
generalo	장군
geno	유전자
gibso(bandaĝ)o	깁스	
gilotino	단두대(斷頭臺)
gitaro	키타
glaciaĵo	아이스크림
glaciejo	빙하
glacimonto,	bankizo	빙산
glacio	얼음
glacipendaĵo	고드름
gladilo	다리미	(malĉifi	veston)
glano	도토리
glaso	글라스,	잔
glavo	검(劍)
glavofiŝo	갈치
globkrajono	볼펜
glubendo	스카치테이프
glumarko	스티커	
gluo,	gluaĵo	풀(붙이는-)
golulo	골키퍼	
gongo	종(鐘)
gorĝo	목(구멍),	식도
granato	석류
gravito	중력(重力)
grenado	수류탄
gutetigilo	스프레이
guto	물방울
hajlo	우박
halthorloĝo	스톱워치
harpinglo	머리핀
harpo	하프(악기)
haŭto	피부
haveno	항구
hejmloko	고향
hejmpaĝo	홈페이지
hepato	간(肝)
heredaĵo	유산(遺産)
heredanto	상속인(相續人)
Herzberg	헤르즈베르크
hibisko	무궁화
hieno	하이에나
hipnotismo	최면술	
hipopotamo	하마(河馬)
hirudo	거머리
hirundo	제비
homo	인간
homtruo	맨홀
horizontalo	수평선,	지평선
horloĝo	시계(時計)
hospitalo	병원
hotelo	호텔
huffero	편자
hufo	발굽
huligano	깡패	
hundo	개
iglo	독수리
imperiestro	황제(皇帝)
importisto	수입업자
imposto	세금(稅金)
indiano	인디언
indiĝeno	원주민
infanĉareto	유모차
infanĝardeno	유치원
injektilo	주사기,	주입기
inko	잉크
inkubatoro	인큐베이터
insekto	곤충
insigno	뱃지
insulo	섬
intermanĝeto	간식
interreto	인터넷
intervjuo	인터뷰
inundo	홍수
jahurto	요구르트
jogano	요가수행자
juĝisto	판사
juglando	호두
jugo	멍에
jupo	치마
juvelo	보석
kabano	오두막집
kablotramo/	-trajno	케이블카
kadro	de	pentraĵo	사진틀
kafo	커피
kafopaŭzo	커피브레이크
kahelo	타일
kajereto,	notlibreto	수첩
kajto	(flugdrako)	연(鳶)
kakto	선인장
kalejdoskopo	요지경,만화경	
kalendaro	달력
kaligrafo	서예가(書藝家)	
kalkulilo	계산기
kalo	못,	굳은살
kalvulo	대머리
kamelio	동백(꽃)
kamelo	낙타
kameno	벽난로
kamentubo	굴뚝
kamiono	화물차
kanalo	운하(運河)
kandelo	초,	양초
kandidato	후보자,	지원자	
kanguruo	캥거루
kanibalo	식인종	
kanjono	협곡,	깊은	계곡
kano	갈대
kanono	포,	대포
kanto	노래
kapkuseno	베개
kapro	염소
kapsiko	고추
kapuĉo	두건,	모자
karaso	붕어(물고기)
karavano	(여행)단체
karbo	석탄,	숯
karcero,	malliberejo	감옥
kariertabelo	이력서	
karolo	캐럴
karoto	당근
karto	카드
kaskado	폭포
kasko	투구,	철모
kaŝtano	밤[栗]
kastelo	성(城)
katalogo	카탈로그
kateno	수갑
kato	고양이
kaverno	동굴
kegloludo	볼링놀이
kelnero	사환,	급사
kelo	지하실
kino/	~ejo	영화	/	영화관
kiosko	가판대,	가두	판매대
kiraso	갑옷
kirurgo	외과의사
klaŭno	어릿광대,	익살꾼	
klifo	절벽(해변의-)	
klimatizilo	에어컨
klozetpapero	화장지
kofro	트렁크
koko	닭
kokoso	야자열매	
kokosujo,	kokosarbo야자수
kolbaso	순대,	소시지
kolego	동료
kolo	목[頸]
kolombo	비둘기
kolonio	식민지
kolono	기둥
koloseo	콜로세움
kolringo	못걸이
kolumbario	납골당
Kolumbo	콜럼버스
kombilo	빗
komencanto	초보자
komercisto	장사꾼
kometo	혜성(彗星)
komikulo	익살꾼	
kompakt¬disko	씨디,	CD
kompaso	나침반(羅針盤)
komputila	pirato	해커	
komputilo	컴퓨터
komunismo	공산주의
koncerto	콘서트
kondimento	양념
konfitaĵo	잼
konko	조가비
konsilanto	자문,	조언자
kontanto	현찰
kontinento	대륙
konvekto	대류(對流)
kopiilo	복사기	
koralo	산호(珊瑚)
korbo	바구니
korbopilko	농구
korno	뿔
koro	마음,	심장
koruso	(ĥoro)	합창단
kosmetiko	(~aĵo)	화장법(화장품)
kosmo	우주(宇宙)
kosmoso	코스모스
kotono	솜
koverto	봉투
kovrilo	표지,	뚜껑
krabo	게[蟹]
krajono	연필
kranio	두개(頭蓋)
krano	꼭지(수도,	가스의-)	
kratero	분화구(噴火口)
kravato	넥타이
kreditkarto	신용카드	
krepusko	(vesper~)	황혼
kresto	볏,	산마루(닭의-)	
kreto	백목,	분필
krevmaizo	팝콘
krimulo	죄인
kriplulo	장애인(障碍人)
krokodilo	악어
krono	왕관;	화환
kruro	다리(동물의-)	
krutaĵo	절벽
kubo	입방체
kudrilo	바늘
kudromaŝino	재봉틀
kuirejo	주방
kuirpoto	솥
kuko	과자
kukolo	뻐꾸기
kukumo	오이
kukurbo	호박
kulero	숟가락
kuniklo	토끼
kunsido	회의(會議)
kuracisto	의사(醫師)
kurciĝvojo	사거리,	네거리	
kuristo	심부름꾼
kurteno	커튼
kuseno	쿠션,	방석	
kuzo	사촌
kvitanco	영수증
ladskatolo	캔
lafo	용암(鎔巖)
lageto	연못	
lago	호수
lakto	우유
laktuko	상추
lambastono	목발
lampiro	개똥벌레
lampo	램프,	등(燈)
lanco	창(槍)
landlimo	국경
lango	혀
larmo	눈물
latitudo	위도(緯度)
laŭtparolio	스피커,	확성기
lavango	눈사태	
lavomaŝino	세탁기
lavopelvo,	lavovazo	세숫대
ledo	가죽
leono	사자(獅子)
leopardo	표범
leporo	산토끼
leprulo	나병환자
lernejo	학교
lernoĉambro	교실
lernokotizo	수업료,	등록금
lernosako	책가방
letero	편지
leviero,	levilo	지렛대
libelo	잠자리
libro	책
lifto	엘리베이터(사람용)
lilio	백합화
lito	침대
lombardejo	전당포
longitudo	경도(經度)
luktado	씨름
lulilo,	lulkorbo	요람
lulkanto	자장가
lumturo	등대
luno	달
lupeo	(grandigaj	vitroj)	확대경
lupo	늑대
maĉgumo	껌
magiisto	마술사(魔術師)
magneto	자석(磁石)
magnolio	목련화
maĝobastonetoj	젓가락
maizo	옥수수
majstro	대가,스승,달인
makolio	막걸리
malalta	tajdo	썰물	
malliberejo	감옥
malsano	병(病)
malvarmumo	감기
mambestoj(mamuloj)포유동물
mamzono	브래지어
mandarino	귤
manĝaĵo	음식
manĝoskatolo	도시락
manifestacio	데모,	시위
manlibro	편람(便覽)
mano	손[手]
manpremo	악수
mansako	핸드백
mansardo	다락방
mantuko	손수건
manuskripto	원고
mapo	지도(地圖)
maratono	마라톤
marĉo	늪
marioneto	꼭두각시	
maro	바다
marsko	갯벌
martelo	망치,	해머
martiro	순교자	
marvirino	인어(人魚)
masaĝo	마사지
masko	가면,	탈,	마스크	
matenmanĝo	조식(朝食)
mato	매트,	돗자리
meblo	가구(家具)
medalo	메달
medikamento	약(藥)
Mediteraneo	지중해(地中海)	
mefito	스컹크
mentono	턱
mentoro	멘토,	(청소년의)	지도자
menuo	메뉴
metempsikozo	윤회(輪廻)
meteostacio	기상청
metilernanto	견습생	
metroo	지하철
mevo	갈매기
mielmonato	허니문
mielo	꿀
mikrofono	마이크
mikroskopo	현미경
mimo	무언극	배우
min(ej)o	광산(鑛山)
miniaturo	미니어처	
miopulo	근시안자
miraklo	기적(奇跡)
modelo	모델
mokso	뜸[灸]
monako(-aĥo)	수도사,	수도승,	승려
mondo	세계(世界)
mono	돈
montaro	산맥
monto	산
montra	ŝranko	진열장
mortinto	사자,죽은사람	
moskito,	kulo	모기
moskitvualo(~kurteno)모기장
motorbiciklo	오토바이
motoro	엔진
muelilo	방아,	맷돌,	제분기
muro	벽(壁)
murpentraĵo	벽화(壁畵)
musko	이끼
muskolo	근육
muso	생쥐
muŝo	파리
mutacio	돌연변이
mutulo	벙어리
muzeo	박물관
muziknoto	악보(樂譜)
muziko	음악	
naĝo	수영
najlo	못
nano	손
narkotaĵo	마약,	마취제	
naskiĝloko	고향
nazo	코
naztuko	콧수건
nebulo	안개
necesejo	변소
neĝo	눈[雪]
nepo	손자(孫子)
nesto	보금자리,	둥우리
NIFO	UFO(미확인비행물체)
nigra	tabulo	칠판
nokto	밤
noktoklubo	나이트클럽
nomado	유목민
norda	poluso	북극(北極)
novelo	소설
nubo	구름
nudelo	국수
nutroĉeno	먹이사슬
oazo	오아시스
obelisko	오벨리스크,방첨탑
observatorio	천문대,관측소
obstaklo	장애(물)
oceano	대양(大洋)
oksigeno	산소(酸素)
okulo	눈[眼]
okulvitroj	안경
oleo	기름
olimpikaj	ludoj	올림픽	경기
ombrelo	우산(雨傘)
ombro	그늘
ondo	파도	
ondorompilo	방파제
opero	오페라
opio	아편	
oratoro	웅변가
orbito	궤도
orelo	귀
orelringo	귀걸이
orfejo	고아원
organo	기관(器官)
oriolo	꾀꼬리	
orkestro	오케스트라,	악단	
ornamaĵo	장식품,	장식물
oro	금
oscedo	하품
osto	뼈
otario	물개
ovo	계란
paciento	환자
pacifiko	태평양
pado,arbarvojeto	오솔길	
pafarko	활
pafilo	총(銃)
pakaĵo	짐,	소화물
palaco	궁궐
paliso	말뚝	
palpebrumo	윙크하기
pamfleto	팸플릿
pando	판다(동물)
pano	빵
pantalono	바지
pantoflo	슬리퍼
papago	앵무새
paperkrampilo	스태플러,	호치키스	
paradizo	낙원(樂園)
paralizito	중풍병자
paraŝuto	낙하산
parfumo	향수,	향료
parkejo	주차장
parko	공원
parlamento	(~ano)	국회	(국회의원)
pasaĝero	승객
pasero	참새
pasporto	여권
paŝtejo,	ranĉo	목장(牧場)
pastoro	목사(牧師)
pato,	fritilo	후라이팬
pavilono	정자(亭子)
pavo	공작새
pediatro	소아과의사
pego	딱따구리
pendola	buso	셔틀버스
pendolo	추(시계의)
pensiulo	연금수급자
peonio	모란	
periodaĵo	정기간행물
persiko	복숭아
persimono	감(먹는-)	
peruko	가발(假髮)
pesilo	저울
pesto	페스트
petrolo	석유
pezlevo	(~isto)	역도	(역도선수)	
piano	피아노
pico	피자
piedo	발[足]	
piedpilko	축구
pigo	까치
piĵamo	잠옷
piloto	조종사
pinĉilo	집게
pingveno	펭귄
pinkonuso	(-frukto)솔방울
pino	소나무
pirato	해적
piro	배(과일-)	
placo	광장
plafono	천장
plago	재앙,	재난
plaĝo	해변
planklumoj	각광(脚光)
planko	마루,	바닥	
plastika	kirurgo	성형외과	의사
pleonasmo	바닥짐,사족(蛇足)
pleto	쟁반
plugilo	쟁기
plumnomo	필명(筆名)
plumo	펜,	깃털
pluvo	비[雨]
pluvombrelo	우산(雨傘)
pneŭ(matik)o	타이어
podio	연단(演壇)
policano	경찰관
poligloto	다언어	구사자
polpo	(okpieda)	낙지	(다리가	여덟개의)
pomo	사과(沙果)
ponardo	단검(短劍)
ponto	다리(물	위의-)	
pordfosto	문설주
pordistejo	수위실(守衛室)
pordisto	수위(守衛)
pordo	문(門)	
porko	돼지
portreto	초상화(肖像畵)
poŝo	주머니
poŝtelefono	휴대폰
poŝtisto	우체부
poŝtmarko	우표
poŝtoficejo	우체국
pramo	나룻배
preĝejo	교회
preskribo,	recepto	처방전
prezidento	대통령
princo	(~ino)	왕자	(공주)	
printempa	ekvinokso	춘분(春分)
printempo	봄
profesoro	교수
projekciilo	프로젝터
prokuroro	검사(檢事)
pruno	자두
pufpano	(sponga~)	커스터드	(빵)
pulbazaro	벼룩시장
pulio	도르래
pulmo	폐(肺)
pulo	벼룩
pupitro	보면대
pupo	인형	
puto	우물
rabatvendo	할인판매	
radaro	레이더
radiatoro,	radiilo라디에이터
radiko	뿌리
radioaktiveco	방사능
radioaparato	라디오수신기
rado	바퀴
rafano	무(먹는-)
raketo	로켓
rano	개구리
rato	쥐
raviolo,	ĉina	pasteĉo	만두
razilo	면도기
recepto	처방전,	요리법
refreŝigaĵo	청량음료
reĝo	왕(王)
reklamo	광고
relo	궤도,	레일
remaĉado	반추(反芻)
remilo	노[櫓](배를	젓는-)	
rendevuo	회합,데이트,만남
restoracio	레스토랑,음식점
reta	gazeto	웹진,인터넷잡지
retletero	이메일
reto	망(網),	그물	
revolucio	혁명
rezervujo	(akvo~)	저수지
riĉulo	부자(富者)
rifo	암초(暗礁)
rifuĝinto	망명자	
riglilo	빗장
risorto	용수철
rivero	강(江)
rizkampo	논[沓]
rizo	쌀
roboto	로봇	
roko	바위
roso	이슬	
Roterdamo	로텔담
rozo	장미
rubando	리본	
Rubikono	루비콘	강
ruldomo,domveturilo캠핑카
rulseĝo	휠체어
rulsketilo	인라인스케이트
rulŝtono	조약돌	
[901-1000]
rulŝtuparo	에스컬레이터
sablo	모래
sago	화살	
sako	자루	
sakostrato	막다른	골목
salajro	봉급	
saliko	버드나무
salikoko	새우
salivo	침,	타액(唾液)
salmo	연어
salo	소금
sango	혈액
Sankta	Nikolao	산타클로즈
sapo	비누
satelito	위성(衛星)	
savjako	구명조끼
scen(ej)o	무대
sceptro	홀(笏),	지휘봉
sciuro	다람쥐
segilo	톱
seĝo	의자
sekretario	비서(秘書)
sekreto	비밀
selo	안장(鞍裝)
semaforo	신호등(信號燈)
semo	씨앗	
sepio	(dekpieda)	오징어	
serenado	소야곡,	세레나데
serpento	뱀
seruro	자물쇠
servico	반상기
sezamo	참깨
siesto	낮잠
sigelo	도장
simio	원숭이
simulanto	꾀병환자
sinbano	목욕
sireno	사이렌
skajpo	스카이프
skanilo	스캐너
skarpo	목도리,	스카프	
skermado	펜싱
sketilo	스케이트
skio	스키
skorpio	전갈
skrapgumo	고무	지우기
skribtablo	책상
skulptaĵo	조각품
sledo	썰매	
sofo	소파
sojlo	문지방,	문턱
sojsaŭco	간장
soldato	사병(士兵)
somera	solstico	하지(夏至)	
someraj	ferioj	여름휴가
somero	여름
somnamblulo	몽유병환자
spegulo	거울
spektanto	관람객,	구경꾼
spinaco	시금치
spino,	vertebraro	척주
spiono	간첩	
sprono	박차(拍車)
spuro,	piedsigno	발자국,	발자취,	흔적	
stadiono	스타디움
stalo	우리(짐승의-)	
stampilo	스탬프	
statuo	상(像),	조각상
stelo	별
stepo	대초원
stetoskopo	청진기
stevardino	스튜어디
stipendiulo	장학생
stirilo,	direktilo	운전핸들stomako	위(胃)
strando,	plaĝo	해변
stratlanterno	가로등
strato	거리
struto	타조
stuci	손질하다	(나무를-)	
stumpo	그루터기	
submarŝipo	잠수함
subtitolo	자막,	부제
sukero	설탕
sukringo	나이테
suna	sistemo	태양계
suno	태양
sunombrelo	양산(陽傘)	
sunvitroj	선글라스
surdulo	귀머거리
surfado	파도타기
surfo	파도(밀려드는-)
surfotabulo	파도타기	널	
surtuto	외투
svatanto	(-isto)	중매인
tablo	테이블
tabloteniso	탁구
tagiĝo	새벽
tagmanĝo	점심식사
tago	낮,	날
tajdo	조수(潮水)간만(干滿)	
tajfuno	태풍
taksio	택시
talpo	두더지
tamburisto	북치는사람,고수
tanko	탱크
tapiŝo	카펫,	융단,	양탄자	
taso	잔(찻-)
tegmento	지붕
tegolo	기와
teisto	유신론자(有神論者)
telegramo	전보(電報)
teleregilo	리모컨
telerlavujo	싱크대,	개수대
telero	접시
teleskopo	망원경
televidilo	텔레비전
tempopasigo	소일거리,취미
tendo	천막,	텐트
teniso	정구(庭球)
terfalo	산사태
terkulturisto	농부
termobotelo	보온병
termofonto	온천(溫泉)
termometro	온도계,	체온계	
terno	재채기
Tero	(La	~o)	지구(地球)
terpomo	감자
tertremo,	sismo	지진(地震)
tervermo	지렁이
testamento	유언,	유서
testudo	거북이
tigro	호랑이
tineo	좀(모직물을	먹는-)	
tirkesto	서랍
tofuo	두부
tolŝuo,	ŝnurŝuo	운동화
tomato	토마토	
tombo	무덤
tondilo	가위
tondro	천둥
torento	격류(激流)
tornado	토네이도
tornistro,	dorsosako	배낭
trafika	akcidento	교통사고	
trajno	기차(汽車)
tribunalo	법정,재판소
trifolio	클로버
trofeo	트로피,	우승배
trompisto	사기꾼
trono	옥좌(玉座),	왕좌(王座)	
tropika	zono	열대지방	
tropiko	회귀선
tropikoj	열대지방
trotuaro	보도(步道),	인도
trumpeto	트럼펫
trunko,	tigo	줄기,	몸통
tumulto	소동,	소요,	폭동
tunelo	터널
turbo	팽이
turo	탑(塔)
UEA	세계에스페란토협회
UK	세계에스페란토대회
ungotondilo	손톱깎이
Unuiĝintaj	Nacioj	유엔urbodomo	시청(市廳)
vagonaro	열차
vakcinado	예방접종
vakero	카우보이(미국의-)	
vakupurigilo	진공청소기
valizo	여행용	가방
valo	계곡
vangokaveto	보조개
vaporo	수증기
varo	상품(商品)
vartistino	유모(乳母),	보모
vegetarano	채식주의자
vejno	혈관
vekhorloĝo	자명종(自鳴鐘)
velo	돛
velŝipo	돛단배,	범선
veneno	독(毒)
ventflago	풍향계	
ventmontrilo	바람개비	
ventmuelilo	풍차(風車)
vento	바람
ventro	배,	복부(腹部)
ventumilo	부채[扇]
venuso	비너스,절세미인,금성
verando	베란다
verda	stelo	녹성기
vergo	회초리,	나뭇가지	
vertebraro	척주(脊柱)
vespermanĝo	저녁식사
vestarko	옷걸이(어깨모양의)	
vesto	옷
vestŝranko	옷장
veterinaro	수의사
vetludanto	도박꾼
veturilo	교통수단,	탈것
veturmalsano	멀미
veziko	방광,	물집,	수포	
videokamerao비디오카메라
vidvino	과부
vidvo	홀아비	
vinagro	식초
vinbero	포도(葡萄)
vino	포도주
vintra	solstico	동지(冬至)
vintraj	ferioj	겨울방학
vintro	겨울
vintrodormo	동면(冬眠)
violonĉelo	첼로
violono	바이올린
vipo	채찍
viŝilo	닦는	기구
viŝtuko	걸레
vitro	유리
vizaĝo	얼굴
vizitkarto	명함
vizo	비자
voĉkordoj	성대(聲帶)
vojaĝagentejo	여행사
vojmontrilo	이정표(里程標)
vojponto	육교(陸橋)
vojponto	육교(陸橋)
volanludo	배드민턴,제기차기
Volapǖko	볼라퓌크
volejbalo	배구
vortaro	사전(辭典)
vualo	베일
vulkano	화산
vulpo	여우	
vundo	상처
Zamenhof	자멘호프
zipo	지퍼
zono	혁대
zoo(logia	ĝardeno)	동물원
zookulturado	축산(畜産)
ĉapano	샴페인
ĉapelo	모자(帽子)
ĉarlantano	돌팔이의사	
ĉarniro	돌쩌귀
ĉasaviadilo	전투기
ĉasisto	사냥꾼	
ĉefurbo	수도(首都),	서울
ĉeko	수표(手票)
ĉelo	세포(細胞)
ĉemizo	셔츠
ĉenkanto	윤창,돌림노래
ĉeno	체인	
ĉerizfloro	벚꽃
ĉerko	관(棺)
ĉevalo	말[馬]
ĉevrono	서까래[椽木]
ĉiĉerono	관광안내원
ĉielarko	무지개
ĉielo	하늘
ĉielskrapulo	마천루
ĉifono	누더기,	넝마	
ĉiovendejo	백화점
ĉizilo	끌,	정
ĝangalo	정글
ĝardenisto	정원사
ĝardeno	정원
ĝemelo	쌍둥이
ĝibulo	곱사등이,	곱
ĝirafo	기린
ĵurnalisto	신문기자
ĵurnalo	신문
ŝafo	양(羊)
ŝaltilo	스위치	
ŝamano	무당
ŝarĝoaŭto	화물차
ŝarko	상어
ŝaŭmo,	bobelo	거품
ŝelo	껍질
ŝido	방패,	간판
ŝimo	곰팡이
ŝipo	배,	선박
ŝlosilo	열쇠
ŝmiraĵo	연고(軟膏)
ŝmirmono	뇌물
ŝnuro	밧줄,	로프,	끈	
ŝnurtira	lukto	줄다리기
ŝoforo	운전사
ŝovelmaŝino	포크레인ŝpateto	호미
ŝpato	삽,	가래	
ŝprucigilo	스프링클러
ŝraŭbo	나사,	볼트
ŝraŭboturnilo	나사드라이버
ŝtelisto	도둑
ŝtono	돌
ŝtrumpeto	양말
ŝtrumpo	스타킹
ŝtuparo	층계,	층층대
ŝtupetaro	사닥다리
ŝukorno	구두주걱
ŝuldanto	채무자
ŝuo	구두
ŝuŝranko	신발장
ŝvito	땀
